针插	explore/zhencha
竹子	explore/bamboo
萝莉塔风格	explore/lolita
服装类专题页面	explore/fuzhuangleizhuantiyemian
灯塔	explore/dengta
花边边框素材	explore/huabianbiankuangsucai
icon教程	explore/iconjiaocheng
秋千	explore/swing
色系搭配	explore/sexidapei
时装发布	explore/shizhuangfabu
2015字样设计	explore/2015ziyangsheji
咖啡杯	explore/kafeibei
森女	explore/sennv
木制品	explore/muzhipin
旅游Banner	explore/lvyoubanner
新年贺卡	explore/xinnianheka
肚兜	explore/dudou
米通花	explore/eyelet
杯垫	explore/beidian
花呢	explore/huani
蜂蜜包装	explore/fengmibaozhuang
台历设计	explore/tailisheji
踝镯鞋	explore/huaizhuoxie
摩天轮	explore/motianlun
帆布鞋	explore/fanbuxie
玫瑰	explore/rose
钥匙扣	explore/yuechikou
门头设计	explore/mentousheji
男士西装	explore/nanshixizhuang
园林设计	explore/yuanlinsheji
可乐	explore/cola
字母图案	explore/zimuzhuangshifushi
字母人物插画	explore/zimurenwuchahua
静物素描	explore/jingwusumiao
露珠	explore/luzhu
立体装饰	explore/litizhuangshi
王冠	explore/crown
几何纹	explore/jihewen
接缝	explore/jiefeng
钢笔画	explore/gangbihua
艺术杂志封面	explore/yishuzazhifengmian
文字图片	explore/wenzitupian
跑车	explore/paoche
熊猫	explore/panda
网页设计	explore/wangyesheji
CG怪物	explore/cgguaiwu
刺绣服饰	explore/cixiufushi
商务PPT设计	explore/shangwupptsheji
印花矢量图案	explore/yinhuashiliangtuan
欧洲宫廷服饰	explore/ouzhougongtingfushi
芭蕾	explore/ballet
招聘海报	explore/zhaopinhaibao
墙面装饰	explore/walldecoration
iPhone摄影	explore/iphonephotography
背带裤	explore/beidaiku
印花	explore/yinhua
40年代时装	explore/40niandaishizhuang
帆布包	explore/fanbubao
服饰陈列	explore/fushichenlie
超现实主义摄影	explore/chaoxianshizhuyisheying
网站引导	explore/wangzhanyindao
交互小动画	explore/jiaohuxiaodonghua
贺卡设计	explore/hekasheji
眼镜	explore/yanjing
卡片设计	explore/kapiansheji
校徽设计	explore/xiaohuisheji
DIY发饰	explore/diyfashi
白色主题名片	explore/baisezhutimingpian
草编帽	explore/caobianmao
帽子	explore/maozi

双重曝光	explore/shuangchongbaoguang
中国风插画	explore/zhongguofengchahua
电子表	explore/dianzibiao
微距摄影	explore/weijusheying
唇画	explore/chunhua
植物插画	explore/zhiwuchahua
牛奶包装	explore/niunaibaozhuang
行业logo	explore/hangyelogo
真火壁炉	explore/zhenhuobilu
阁楼	explore/gelou
日本电影海报	explore/ribendianyinghaibao
金饰	explore/jinshi
抱枕	explore/baozhen
凳子设计	explore/dengzisheji
新娘头饰	explore/xinniangtoushi
蕾丝连衣裙	explore/leisilianyiqun
日本街拍	explore/ribenjiepai
动物摄影	explore/dongwusheying
简约风格家居	explore/jianyuefenggejiaju
皮衣	explore/piyi
包装袋设计	explore/baozhuangdaisheji
印花T恤	explore/yinhuaTxu
铆钉	explore/maoding
lomo摄影	explore/lomosheying
头纱	explore/tousha
蒸汽朋克	explore/zhengqipengke
窗帘	explore/chuanglian
手绘icon	explore/shouhuiicon
高腰婚纱	explore/gaoyaohunsha
游戏icon	explore/youxiicon
音乐icon	explore/yinyueicon
怀旧海报	explore/huaijiuhaibao
版面设计	explore/banmiansheji
logo	explore/logo
秀场细节	explore/xiuchangxijie
引导页	explore/yindaoye
时装大片	explore/shizhuangdapian
时装周	explore/shizhuangzhou
龙猫	explore/longmao
橡皮章	explore/xiangpizhang
卫生间	explore/weishengjian
中式家具	explore/zhongshijiaju
柠檬	explore/lemon
兔	explore/rabbit
吉他	explore/guitar
郁金香	explore/tulip
田野	explore/tianye
马	explore/horse
虎	explore/hu
集市	explore/jishi
酒类画册	explore/jiuleihuace
新年插画	explore/xinnianchahua
新年搭配	explore/xinniandapei
2015日历设计	explore/2015rilisheji
印度服饰	explore/yindufushi
工笔画	explore/gongbihua
甜美风搭配	explore/tianmeifengdapei
欧美风搭配	explore/oumeifengdapei
茶具	explore/chaju
圣诞树	explore/shengdanshu
气球	explore/balloon
千纸鹤	explore/qianzhihe
拖鞋	explore/tuoxie
奔跑	explore/run
牵手	explore/qianshou
拥抱	explore/hug
吻	explore/kiss
穆勒鞋	explore/mules
沙漠	explore/desert
几何素材	explore/jihesucai
溶图素材	explore/rongtusucai
高光素材	explore/gaoguangsucai
古风素材	explore/gufengsucai
古风海报	explore/gufenghaibao
滚边名片	explore/gunbianmingpian
景观手绘	explore/jingguanshouhui
渐变背景	explore/jianbianbeijing
搪瓷杯	explore/tangcibei
秋季搭配	explore/qiujidapei
春季搭配	explore/chunjidapei
冬季搭配	explore/dongjidapei
风筝	explore/kite
风车	explore/fengche
捕梦网	explore/bumengwang
星座插画	explore/xingzuochahua
夏季搭配	explore/xiajidapei
圣诞家装	explore/shengdanjiazhuang
零钱包	explore/lingqianbao
圣诞穿搭	explore/shengdandapei
圣诞橱窗	explore/shengdanchuchuang
寸头	explore/cuntou
万圣节插画	explore/wanshengjiechahua
圣诞背景图案	explore/shengdanbeijingtuan
短款钱包	explore/duankuanqianbao
长款钱包	explore/changkuanqianbao
家居类专题页面	explore/jiajuleizhuantiyemian
鞋包类专题页面	explore/xiebaoleizhuantiyemian
欧美专题页面	explore/oumeizhuantiyemian
时间轴设计	explore/shijianzhousheji
男士发型	explore/nanshifaxing
酒店客房设计	explore/jiudiankefangsheji
游戏专题页面	explore/youxizhuantiyemian
日韩专题页面	explore/rihanzhuantiyemian
扁平化专题页面	explore/bianpinghuazhuantiyemian
角斗士鞋	explore/jiaodoushixie
富士山	explore/fujisan
开普托鞋	explore/kaiputuoxie
山	explore/shan
布洛克鞋	explore/buluokexie
男装时装周	explore/nanzhuangshizhuangzhou
发带	explore/fadai
旋转木马	explore/xuanzhuanmuma
音乐节街拍	explore/yinlejiejiepai
数码类专题页面	explore/shumaleizhuantiyemian
汽车类专题页面	explore/qicheleizhuantiyemian
婚纱摄影专题页面	explore/hunshasheyingzhuantiyemian
产品设计手绘稿	explore/chanpinshejishouhuigao
产品细节	explore/chanpinxijie
动物图标	explore/dongwutubiao
甜甜圈	explore/donut
信	explore/letter
便当	explore/biandang
百褶裙	explore/baizhequn
吊带裙	explore/diaodaiqun
钟表	explore/zhongbiao
抹胸裙	explore/moxiongqun
圣诞手机壁纸	explore/shengdanshoujibizhi
DM折页	explore/dmzheye
节日海报	explore/jierihaibao
植物logo	explore/zhiwulogo
动物logo	explore/dongwulogo
花瓶	explore/huaping
羊年海报	explore/yangnianhaibao
四叶草	explore/siyecao
雪山	explore/xueshan
纸杯蛋糕	explore/cupcake
雏菊	explore/chuju
龙卷风	explore/longjuanfeng
孔明灯	explore/kongmingdeng
马卡龙色搭配	explore/makalongsedapei
中式花纹纹样	explore/zhongshihuawenwenyang
欧式花纹纹样	explore/oushihuawenwenyang
皮带	explore/pidai
手绘英文涂鸦	explore/shouhuiyingwentuya
POLO衫	explore/poloshan
情侣装	explore/qinglvzhuang
闺蜜装	explore/guimizhuang
IT GIRL	explore/it-girl
名媛风	explore/mingyuanfeng
黑白灰搭配	explore/heibaihuidapei
糖果色搭配	explore/tangguosedapei
波普插画	explore/bopuchahua
卡通笑脸	explore/katongxiaolian
波普艺术	explore/bopuyishu
唐卡	explore/tangqia
泸沽湖	explore/luguhu
胶片摄影	explore/jiaopiansheying
笑脸	explore/xiaolian
梨花	explore/lihua
蝴蝶	explore/butterfly
玻璃杯	explore/bolibei
希腊	explore/xila
马尔代夫	explore/maerdaifu
纸箱人阿楞	explore/danboard
眼睛	explore/yanjing-1
耳机	explore/erji
孕妇照	explore/yunfuzhao
纽扣DIY	explore/niukoudiy
路灯	explore/ludeng
旗帜	explore/flag
操场	explore/caochang
课桌	explore/kezhuo
牛奶	explore/milk
冰淇淋	explore/icecream
欧美人像摄影	explore/oumeirenxiangsheying
亚洲人像摄影	explore/yazhourenxiangsheying
男士皮鞋	explore/nanshipixie
唱片机	explore/recordplayer
吊牌设计	explore/diaopaisheji
立体海报设计	explore/litihaibaosheji
See-Through透视	explore/see-throughtoushi
日本包装设计	explore/ribenbaozhuangsheji
青果领	explore/qingguoling
向日葵	explore/sunflower
彼得潘领	explore/bidepanling
铁轨	explore/rail
钢琴	explore/piano
雪人	explore/snowman
咖啡拉花	explore/coffeegarland
蒲公英	explore/dandelion
笔迹	explore/biji
薰衣草	explore/lavender
樱桃	explore/cherry
民族风服饰	explore/minzufengfushi
双排扣	explore/shuangpaikou
藻井图案	explore/zaojing
牌匾设计	explore/paibiansheji
领夹	explore/lingjia
拍立得	explore/polaroid
酒店设计	explore/jiudiansheji
领结	explore/lingjie
领带	explore/lingdai
景观设计	explore/jingguansheji
复古风搭配	explore/fugufengdapei
秀场镜饰	explore/xiuchangjingshi
秀场帽饰	explore/xiuchangmaoshi
秀场鞋	explore/xiuchangxie
创意包袋	explore/chuangyibaodai
秀场包袋	explore/xiuchangbaodai
秀场头饰	explore/xiuchangtoushi
秀场配饰	explore/xiuchangpeishi
裙子细节	explore/qunzixijie
穹顶	explore/qiongding
男士围巾	explore/nanshiweijin
袖扣	explore/xiukou
披肩	explore/pijian
打火机	explore/dahuoji
舞美设计	explore/wumeisheji
日式园林设计	explore/rishiyuanlinsheji
中式园林设计	explore/zhongshiyuanlinsheji
欧式园林设计	explore/oushiyuanlinsheji
金色服饰	explore/jinsefushi
浮动导航设计	explore/fudongdaohangsheji
羊元素设计	explore/yangyuansusheji
植物图案	explore/zhiwutuan
花卉图案	explore/huahuituan
食品广告	explore/shipinguanggao
直通车Banner	explore/zhitongchebanner
羊插画	explore/yangnianchahua
羊年素材	explore/yangniansucai
哥特式建筑	explore/geteshijianzhu
灯笼	explore/denglong
海港	explore/haigang
风铃	explore/fengling
年画	explore/nianhua
凤冠	explore/fengguan
番茄炒蛋	explore/fanqiechaodan
金鱼	explore/jinyu
绣花鞋	explore/xiuhuaxie
制服同人	explore/zhifutongren
西瓜	explore/watermelon
笑容	explore/xiaorong
校服	explore/xiaofu
动画电影海报	explore/donghuadianyinghaibao
越野车	explore/yueyeche
相机	explore/xiangji
汽车外观	explore/qichewaiguan
抽象画	explore/chouxianghua
时尚杂志封面	explore/shishangzazhifengmian
生活杂志封面	explore/shenghuozazhifengmian
动漫杂志封面	explore/dongmanzazhifengmian
app个人中心设计	explore/appgerenzhongxinsheji
联系我们页面设计	explore/lianxiwomenyemiansheji
圣诞插画	explore/shengdanchahua
app侧边栏设计	explore/appcebianlansheji
网页侧边栏设计	explore/wangyecebianlansheji
平板电脑界面设计	explore/pingbandiannaojiemiansheji
十二生肖海报	explore/shiershengxiaohaibao
艺妓	explore/yiji
眼泪	explore/yanlei
皮革切割	explore/pigeqiege
二十四节气海报	explore/ershisijieqihaibao
泡泡	explore/paopao
环保袋	explore/huanbaodai
倒影	explore/daoying
汽车内饰	explore/qicheneishi
龙猫插画	explore/longmaochahua
皮卡丘	explore/pikaqiu
耽美漫画	explore/danmeimahua
日本手办	explore/ribenshouban
欧美手办	explore/oumeishouban
雕塑	explore/diaosu
卡牌	explore/kapai
侧边栏设计	explore/cebianlansheji
表单设计	explore/biaodansheji
发绳	explore/fasheng
发夹	explore/fajia
国画山水	explore/guohuashanshui
极光	explore/aurora
国画	explore/guohua
极地	explore/jidi
码头	explore/matou
茶	explore/cha
景物素描	explore/jingwusumiao-1
游戏场景	explore/youxichangjing
弹窗设计	explore/danchuangsheji
日韩CG原画	explore/rihancgyuanhua
欧美CG原画	explore/oumeicgyuanhua
欧美插画	explore/oumeichahua
音乐app界面	explore/yinyueappjiemian
天气app界面	explore/tianqiappjiemian
服饰纽扣	explore/button
花卉插画	explore/huahuichahua
波普风平面设计	explore/bopufengpingmiansheji
芦苇	explore/luwei
日韩Banner	explore/rihanbanner
欧美Banner	explore/oumeibanner
风景油画	explore/fengjingyouhua
人物油画	explore/renwuyouhua
编织服饰	explore/bianzhifushi
静物油画	explore/jingwuyouhua
油画	explore/youhua
千鸟格	explore/qianniaoge
背影	explore/beiying
日本插画	explore/ribenchahua
金属色	explore/jinshuse
原宿风	explore/yuansufeng
戏曲人物	explore/xiqurenwu
日韩游戏UI	explore/rihanyouxiui
欧美游戏UI	explore/oumeiyouxiui
游戏按钮	explore/youxianniu
锯齿纹	explore/juchiwen
时装插画	explore/shizhuangchahua
夕阳	explore/xiyang
京剧脸谱	explore/jingjulianpu
肌理感提花	explore/jiligantihua
日式庭院	explore/rishitingyuan
花卉图案服饰	explore/huahuituanfushi
宝石首饰	explore/baoshishoushi
LOFT	explore/loft
奥斯卡电影海报	explore/aosiqiadianyinghaibao
动态摄影	explore/dongtaisheying
蜡染	explore/laran
404页面设计	explore/404yemiansheji
古装摄影	explore/guzhuangsheying
梅花	explore/meihua
火车	explore/train
闺蜜照	explore/guimizhao
蝴蝶结	explore/bow
玉器首饰	explore/yuqishoushi
DIY蜡烛	explore/diylazhu
拼贴艺术	explore/pintieyishu
十字绣	explore/shizixiu
插花	explore/chahua
微雕	explore/weidiao
红绳手链	explore/hongshengshoulian
腕饰	explore/wanshi
玻璃瓶DIY	explore/bolipingdiy
情侣照	explore/qinglvzhao
McQueen	explore/mcqueen
演出海报	explore/yanchuhaibao
汽车标志	explore/qichebiaozhi
平面广告	explore/pingmianguanggao
男性CG人设	explore/nanxingcgrenshe
汽车平面广告	explore/qichepingmianguanggao
女性CG人设	explore/nvxingcgrenshe
钉珠	explore/dingzhu
腰饰	explore/yaodai
钻戒	explore/zuanjie
钻石首饰	explore/zuanshishoushi
中国结	explore/zhongguojie
波纹图案	explore/bowentuan
银饰	explore/yinshi
皮艺	explore/piyi-1
天空	explore/sky
设计构图	explore/shejigoutu
拼接	explore/pinjie
二次元	explore/erciyuan
酒柜	explore/jiugui
盘子	explore/plate
可视化信息图设计	explore/keshihuaxinxitusheji
落地窗	explore/luodichuang
Q版插画	explore/qbanchahua
扁平化PPT设计	explore/bianpinghuapptsheji
CG原画	explore/cgyuanhua
发簪	explore/fazan
sale文字素材	explore/salewenzisucai
电商Banner	explore/dianshangbanner
文字排版	explore/wenzipaiban
中国风平面设计	explore/zhongguofengshejisucai
复古风平面设计	explore/fugufengshejisucai
和风图案	explore/hefengtuan
阅读	explore/read
民国风插画	explore/minguofengchahua
伞	explore/san
CG教程	explore/cgjiaocheng
手账	explore/shouzhang
围巾	explore/scarf
蝴蝶纹	explore/hudiewen
丝巾	explore/sizhiweijin
DIY手链	explore/diyshoulian
女装搭配	explore/nvzhuangdapei
女人味搭配	explore/nvrenweidapei
插画头像	explore/chahuatouxiang
自行车	explore/bike
手臂纹身	explore/shoubiwenshen
海军风	explore/haijunfeng
线迹装饰	explore/stitch
彩绘鸡蛋	explore/caihuijidan
雨鞋	explore/yuxie
丽江	explore/lijiang
森林	explore/forest
欧美漫画	explore/oumeimanhua
日本	explore/riben
厦门	explore/xiamen
节日贺卡	explore/jieriheka
芭比娃娃	explore/babiwawa
生日贺卡	explore/shengriheka
情人节贺卡	explore/qingrenjieheka
花纹图案	explore/huawentuan
圣诞贺卡	explore/shengdanheka
服装配色	explore/fuzhuangpeise
面纱	explore/miansha
立体花朵	explore/huaduo
手	explore/hand
婚礼派对	explore/hunlipaidui
婚纱摄影	explore/hunshasheying
饰品专题页面	explore/shipinzhuantiyemian-1
传统图案	explore/chuantongtuan
食品专题页面	explore/shipinzhuantiyemian
化妆品专题页面	explore/huazhuangpinzhuantiyemian
几何图案	explore/jihetuan
旅游专题页面	explore/lvyouzhuantiyemian
彩铅插画	explore/caiqianchahua
平铺图案	explore/pingputuan
水彩插画	explore/shuicaichahua
食品海报	explore/shipinhaibao
日本漫画	explore/ribenmanhua
纹理图案	explore/wenlituan
化妆品Banner	explore/huazhuangpinbanner
和服同人	explore/hefutongren
唯美插画	explore/weimeichahua
化妆品广告	explore/huazhuangpinguanggao
旅游广告	explore/lvyouguanggao
导视设计	explore/daoshisheji
易拉宝设计	explore/yilabaosheji
书籍封面设计	explore/shujifengmiansheji
票券设计	explore/piaoquansheji
怀表	explore/huaibiao
森林系	explore/senlinxi
陶艺	explore/taoyi
复古婚纱	explore/fuguhunsha
热气球	explore/hotairballoon
舟	explore/boat
图案设计	explore/tuansheji
小黑裙	explore/xiaoheiqun
手办	explore/shouban
动物图案	explore/dongwutuan
动物海报	explore/dongwuhaibao
音响	explore/yinxiang
新年专题页面	explore/xinnianzhuantiyemian
拼豆	explore/pindou
绕线	explore/raoxian
挂钟	explore/guazhong
相框	explore/xiangkuang
懒人沙发	explore/lanrenshafa
书签	explore/shuqian
DIY手机壳	explore/diyshoujike
收纳	explore/shouna
哈士奇	explore/hashiqi
狗	explore/dog
猫	explore/cat
无袖旗袍	explore/wuxiuqipao
短袖旗袍	explore/duanxiuqipao
复活节彩蛋	explore/fuhuojiecaidan
鼠标	explore/shubiao
印花矢量图	explore/yinhuashiliangtu
挂钩	explore/guagou
开关贴	explore/kaiguantie
烛台	explore/zhutai
花盆	explore/huapen
肖像画	explore/xiaoxianghua
浴帘	explore/yulian
彩铅教程	explore/caiqianjiaocheng
水彩教程	explore/shuicaijiaocheng
圣诞礼物	explore/shengdanliwu
酒店外观设计	explore/jiudianwaiguansheji
丝带绣	explore/sidaixiu
食品雕刻	explore/shipindiaoke
微型艺术	explore/weixingyishu
DIY相册	explore/diyxiangce
置物架	explore/zhiwujia
树叶画	explore/shuyehua
竹编	explore/zhubian
DIY包装	explore/diybaozhuang
酒店室内设计	explore/jiudianshineisheji
丝绸	explore/sichou
请柬设计	explore/qingjiansheji
灯芯绒	explore/dengxinrong
婚礼纸品	explore/hunlizhipin
天鹅绒	explore/tianerong
工作室	explore/gongzuoshi
邮票设计	explore/youpiaosheji
雨中伞	explore/yuzhongsan
青年布	explore/chambra
明信片设计	explore/mingxinpiansheji
派对装饰	explore/party
传统纹样	explore/chuantongwenyang
姜饼人	explore/gingerbreadmen
美陈设计	explore/meichensheji
草莓	explore/strawberry
城市	explore/city
方形圆形名片	explore/fangxingyuanxingmingpian
圆形名片	explore/yuanxingmingpian
CG线稿	explore/cgxiangao
型男街拍	explore/xingnanjiepai
烫金名片	explore/tangjinmingpian
古着	explore/guzhuo
珠宝	explore/jewelry
型男	explore/xingnan
T恤图案	explore/txutuan
慢速摄影	explore/lowspeedcinematography
loading设计	explore/loadingsheji
网页按钮	explore/wangyeanniu
像素图标	explore/xiangsutubiao
棉麻料	explore/mianmaliao
瓦楞纸	explore/walengzhi
发饰	explore/fashi
网页小图标	explore/wangyexiaotubiao
个人简历设计	explore/gerenjianlisheji
超模	explore/supermodel
商务网站设计	explore/shangwuwangzhansheji
拉链	explore/lalian
烟花	explore/firework
欧美网站设计	explore/oumeiwangzhansheji
日韩网站设计	explore/rihanwangzhansheji
鹿	explore/deer
咖啡	explore/coffee
折叠名片	explore/zhediemingpian
纸服饰	explore/zhifushi
手机壳	explore/shoujike
导航栏设计	explore/daohanglansheji
板鞋	explore/banxie
衬衫	explore/chenshan
连衣裙	explore/lianyiqun
T恤	explore/t-shirt
运动鞋	explore/yundongxie
背纹身	explore/beiwenshen
大海	explore/ocean
夜景	explore/night
3D纹身	explore/3dwenshen
锁骨纹身	explore/suoguwenshen
月亮	explore/moon
胸花	explore/xionghua
艺术头饰	explore/yishutoushi
手套	explore/shoutao
50年代时装	explore/50niandaishizhuang
毕业照	explore/biyezhao
移轴摄影	explore/tiltshiftphotography
雪	explore/snow
灵感图	explore/linggantu
模特妆容	explore/motezhuangrong
隐形门	explore/yinxingmen
墨镜	explore/mojing
门	explore/door
马卡龙	explore/macarons
袜	explore/wa
节气	explore/jieqi
极简服饰	explore/jijianfushi
抽烟	explore/smoke
雨天	explore/rain
裙子	explore/qunzi
短裙	explore/duanqun
落地灯	explore/floorlamp
厚底鞋	explore/houdixie
婚礼男戒	explore/hunlinanjie
单肩包	explore/danjianbao
内衣	explore/neiyi
窗户	explore/chuanghu
邀请函设计	explore/yaoqinghansheji
夹脚鞋	explore/jiajiaoxie
手提包	explore/shoutibao
手拿包	explore/shounabao
台灯	explore/desklamp
咖啡馆装修	explore/kafeiguanzhuangxiu
方形icon	explore/fangxingicon
圆形icon	explore/yuanxingicon
荷叶边	explore/flouncing
门襟	explore/menjin
春秋街拍	explore/chunqiujiepai
香水瓶	explore/xiangshuiping
夏季街拍	explore/xiajijiepai
木质首饰	explore/muzhishoushi
美式乡村风服饰	explore/meishixiangcunfengfushi
玉石	explore/yushi
短靴	explore/duanxue
坡跟鞋	explore/pogenxie
鱼嘴鞋	explore/yuzuixie
圆头鞋	explore/yuantouxie
栏目标志	explore/lanmubiaozhi
台标设计	explore/taibiaosheji
冬季街拍	explore/dongjijiepai
游戏登录界面	explore/youxidenglujiemian
裤子	explore/kuzi
APP登录界面	explore/appdenglujiemian
卡通字体	explore/katongziti
牛皮钱包	explore/niupiqianbao
3D字体	explore/3dziti
衣柜	explore/closet
流星	explore/meteor
游戏logo	explore/youxilogo
平底鞋	explore/pingdixie
牛仔衬衫	explore/niuzaichenshan
雪地靴	explore/xuedixue
铁艺	explore/tieyi
牛仔短裤	explore/niuzaiduanku
牛津鞋	explore/niujinxie
牛仔长裤	explore/niuzaichangku
牛仔外套	explore/niuzaiwaitao
POP字体	explore/popziti
儿童摄影	explore/ertongsheying
游戏字体	explore/youxiziti
商务名片	explore/shangwumingpian
20年代时装	explore/20niandaishizhuang
钱包	explore/qianbao
英文字体设计	explore/yingwenzitisheji
中文字体设计	explore/zhongwenzitisheji
植物家居	explore/zhiwujiaju
皮鞋	explore/pixie
尖头鞋	explore/jiantouxie
长靴	explore/changxue
品牌时装大片	explore/pinpaishizhuangdapian
马丁鞋	explore/madingxie
外套	explore/waitao
凉鞋	explore/liangxie
手袋	explore/shoudai
串珠	explore/chuanzhu
椅子	explore/chair
促销banner	explore/cuxiaobanner
羽毛	explore/yumao
斜挎包	explore/xiekuabao
和服	explore/hefu
洛可可服饰	explore/luokekefushi
圣诞装饰	explore/christmasdecorate
春节素材	explore/chunjiesucai
橱窗陈列	explore/windowdisplay
黄色主题名片	explore/huangsezhutimingpian
红色主题名片	explore/hongsezhutimingpian
蓝色主题名片	explore/lansezhutimingpian
绿色主题名片	explore/lvsezhutimingpian
单鞋	explore/danxie
拼布	explore/patchwork
手绘石头	explore/shouhuishitou
维多利亚的秘密	explore/victoriassecret
毛线帽	explore/maoxianmao
情人节素材	explore/qingrenjiesucai
圣诞节素材	explore/shengdanjiesucai
耳坠	explore/erzhui
毛衣	explore/maoyi
耳钉	explore/erding
发箍	explore/fagu
手链	explore/shoulian
手镯	explore/shouzhuo
轻纱	explore/qingsha
礼帽	explore/limao
彩虹色	explore/caihongse
双肩包	explore/shuangjianbao
棒球帽	explore/bangqiumao
樱花	explore/yinghua
贝雷帽	explore/beileimao
落叶	explore/luoye
鸭舌帽	explore/yashemao
高速摄影	explore/gaosusheying
马夹	explore/majia
强迫透视	explore/qiangpotoushi
胸针	explore/xiongzhen
悬浮摄影	explore/xuanfusheying
亮片	explore/liangpian
多次曝光	explore/duocibaoguang
亚克力	explore/yakeli
白衬衫	explore/baichenshan
光绘摄影	explore/guanghuisheying
伦敦时装周	explore/lundunshizhuangzhou
米兰时装周	explore/milanshizhuangzhou
巴黎时装周	explore/balishizhuangzhou
纽约时装周	explore/niuyueshizhuangzhou
粉色婚礼	explore/fensehunli
铁塔	explore/tieta
插画教程	explore/chahuajiaocheng
衣摆	explore/yibai
口袋	explore/koudai
花苞头	explore/huabaotou
梨花头	explore/lihuatou
彩色服装效果图	explore/caisefuzhuangxiaoguotu
大波浪	explore/dabolang
黑白服装效果图	explore/heibaifuzhuangxiaoguotu
渐变发色	explore/jianbianfase
BOBO头	explore/bobotou
中分	explore/zhongfen
染发	explore/ranfa
房地产DM	explore/fangdichanDM
卫衣	explore/weiyi
华语电影海报	explore/huayudianyinghaibao
房地产画册	explore/fangdichanhuace
科幻电影海报	explore/kehuandianyinghaibao
背心	explore/beixin
飘窗	explore/piaochuang
冷门电影海报	explore/lengmendianyinghaibao
欧美电影海报	explore/oumeidianyinghaibao
纪实摄影	explore/jishisheying
盘发	explore/panfa
编发	explore/bianfa
SD娃娃	explore/SDwawa
长发	explore/changfa
企业宣传册	explore/qiyexuanchuance
半身裙	explore/banshenqun
短发	explore/duanfa
衣帽间	explore/yimaojian
木工	explore/mugong
短裤	explore/duanku
羽绒服	explore/yurongfu
军装	explore/junzhuang
长裤	explore/changku
牛皮纸包装	explore/niupizhibaozhuang
风景摄影	explore/fengguangsheying
毛衫	explore/maoshan
创意包装	explore/chuangyibaozhuang
韩国电影海报	explore/hanguodianyinghaibao
手腕花	explore/shouwanhua
立体涂鸦	explore/litituya
平面涂鸦	explore/pingmiantuya
街头涂鸦	explore/jietoutuya
喜糖盒	explore/xitanghe
换鞋凳	explore/huanxiedeng
人像摄影	explore/renxiangsheying
喜糖	explore/xitang
面料再造	explore/mianliaozaizao
婚礼请柬	explore/hunliqingjian
食品包装	explore/shipinbaozhuang
苔藓微景观	explore/taixianweijingguan
逆光摄影	explore/jianyingsheying
戒指	explore/jiezhi
皮草	explore/picao
女式西装	explore/nvshixizhuang
茶叶包装	explore/chayebaozhuang
电梯广告	explore/diantiguanggao
航空摄影	explore/hangkongsheying
天文摄影	explore/tianwensheying
CG模型	explore/cgmoxing
CG道具	explore/cgdaoju
CG人设	explore/cgrenshe
美式乡村风格家居	explore/meishixiangcunfenggejiaju
花园	explore/huayuan
吉祥物插画	explore/jixiangwuchahua
书桌	explore/shuzhuo
黑白海报	explore/heibaihaibao
极简海报	explore/jijianhaibao
欧美海报	explore/oumeihaibao
婚戒	explore/hunjie
手捧花	explore/shoupenghua
吊灯	explore/diaodeng
日本海报	explore/ribenhaibao
婚礼蛋糕	explore/hunlidangao
咖啡包装	explore/kafeibaozhuang
短袖衬衫	explore/duanxiuchenshan
渐变色	explore/jianbianse
香水包装	explore/xiangshuibaozhuang
衣领	explore/yiling
拼色服饰	explore/pinsefushi
长袖衬衫	explore/changxiuchenshan
日系摄影	explore/rixisheying
酒包装	explore/jiubaozhuang
茶几	explore/chaji
梳妆台	explore/shuzhuangtai
面具	explore/mianju
艺术妆	explore/yishuzhuang
毛衣链	explore/maoyilian
锁骨链	explore/suogulian
项链	explore/xianglian
名表	explore/mingbiao
手链表	explore/shoulianbiao
褶皱服饰	explore/zhezhoufushi
情人节专题页面	explore/qingrenjiezhuantiyemian
背心裙	explore/beixinqun
短袖连衣裙	explore/duanxiulianyiqun
长袖连衣裙	explore/changxiulianyiqun
伴娘服	explore/banniangfu
黑白摄影	explore/heibaisheying
圣诞节专题页面	explore/shengdanjiezhuantiyemian
棉服	explore/mianfu
婴儿床	explore/yingerchuang
座椅	explore/zuoyi
婚纱背面	explore/hunshabeimian
蓝色婚礼	explore/lansehunli
中式婚礼	explore/zhongshihunli
创意工业设计	explore/chuangyigongyesheji
森系婚礼	explore/senxihunli
橙色婚礼	explore/chengsehunli
紫色婚礼	explore/zisehunli
复古表	explore/fugubiao
手表	explore/shoubiao
圆珠笔画	explore/yuanzhubihua
建筑插画	explore/jianzhuchahua
水晶	explore/shuijing
水果插画	explore/shuiguochahua
静物插画	explore/jingwuchahua
全景摄影	explore/quanjingsheying
北大校花	explore/beidaxiaohua
礼物	explore/liwu
静物摄影	explore/jingwusheying
摩托车外观设计	explore/motuochewaiguansheji
概念摩托车	explore/gainianmotuoche
摩托车	explore/motuoche
花童	explore/huatong
产品设计	explore/chanpinsheji
羊毛毡服饰	explore/yangmaozhanfushi
珍珠	explore/zhenzhu
手机游戏界面	explore/shoujiyouxijiemian
婚鞋	explore/hunxie
双肩婚纱	explore/shuangjianhunsha
针织外套	explore/zhenzhiwaitao
扁平化手机主题	explore/bianpinghuashoujizhuti
挂脖婚纱	explore/guabohunsha
中式婚纱	explore/zhongshihunsha
白色系Banner	explore/baisexiBanner
vera wang	explore/verawang
书架	explore/shujia
地毯	explore/ditan
插画风格名片	explore/chahuafenggemingpian
二维码名片	explore/erweimamingpian
凸版名片	explore/tubanmingpian
美甲	explore/meijia
非纸质名片	explore/feizhizhimingpian
透明名片	explore/toumingmingpian
海娜纹身	explore/hainawenshen
紫色系Banner	explore/zisexiBanner
新娘妆	explore/xinniangzhuang
绿色系Banner	explore/lvsexiBanner
蕾丝婚纱	explore/leisihunsha
蓝色系Banner	explore/lansexiBanner
黄色系Banner	explore/huangsexiBanner
旧物改造	explore/jiuwugaizao
红色系Banner	explore/hongsexiBanner
榻榻米	explore/tatami
假领	explore/jialing
复古鞋	explore/fuguxie
动画海报	explore/donghuahaibao
韩国插画	explore/hanguochahua
喵星人插画	explore/miaoxingrenchahua
复古怀旧海报	explore/fuguhuaijiuhaibao
文字排版海报	explore/wenzipaibanhaibao
风景插画	explore/fengjingchahua
旗袍	explore/qipao
手绘名片	explore/shouhuimingpian
黑白名片	explore/heibaimingpian
异型名片	explore/yixingmingpian
异形名片	explore/1
新娘发型	explore/xinniangfaxing
少女妆	explore/shaonvzhuang
晚宴妆	explore/wanyanzhuang
巧克力包装	explore/qiaokelibaozhuang
动物插画	explore/dongwuchahua
沙发	explore/shafa
墙纸	explore/qiangzhi
扁平化Banner	explore/bianpinghuaBanner
毛呢外套	explore/maoniwaitao
长袖婚纱	explore/changxiuhunsha
斗篷	explore/doupeng
风衣	explore/fengyi
扁平化ui	explore/bianpinghuaui
短款婚纱	explore/duankuanhunsha
美食插画	explore/meishichahua
人物插画	explore/renwuchahua
铁盒包装	explore/tiehebaozhuang
纸盒包装	explore/zhihebaozhuang
鲜花包装	explore/xianhuabaozhuang
月饼包装	explore/yuebingbaozhuang
数码产品包装	explore/shumachanpinbaozhuang
化妆品包装	explore/huazhuangpinbaozhuang
CD包装	explore/cdbaozhuang
促销海报	explore/cuxiaohaibao
中国老海报	explore/zhongguolaohaibao
长裙	explore/changqun
星空	explore/xingkong
公益海报	explore/gongyihaibao
音乐海报	explore/yinyuehaibao
电影海报	explore/dianyinghaibao
折纸	explore/zhezhi
剪纸	explore/jianzhi
手绘UI界面	explore/shouhuiUIjiemian
UI界面原型	explore/UIjiemianyuanxing
大衣	explore/dayi
GUI动效	explore/GUIdongxiao
格子衬衫	explore/gezichenshan
GUI手机界面	explore/GUIshoujijiemian
GUI控件	explore/GUIkongjian
格子裙	explore/geziqun
GUI挂件	explore/GUIguajian
饮料包装	explore/yinliaobaozhuang
卷发	explore/juanfa
烟熏妆	explore/yanxunzhuang
杂志时装大片	explore/zazhishizhuangdapian
文字形变logo	explore/wenzixingbianlogo
3D立体感logo	explore/3dlitiganlogo
手绘logo	explore/shouhuilogo
英文logo	explore/yingwenlogo
中文logo	explore/zhongwenlogo
CD封面	explore/CDfengmian
摄影后期	explore/sheyinghouqi
水下摄影	explore/shuixiasheying
写实插画	explore/xieshichahua
电视背景墙	explore/dianshibeijingqiang
儿童房	explore/ertongfang
食品摄影	explore/shipinsheying
地中海风格家居	explore/dizhonghaifenggejiaju
田园风格家居	explore/tianyuanfenggejiaju
拟物化icon	explore/niwuhuaicon
格子外套	explore/geziwaitao
鱼尾婚纱	explore/yuweihunsha
牛仔裙	explore/niuziqun
一字领婚纱	explore/yizilinghunsha
扁平化icon	explore/bianpinghuaicon
牛仔衣	explore/niuziyi
前短后长婚纱	explore/qianduanhouchanghunsha
牛仔裤	explore/niuzaiku
黑白logo	explore/heibailogo
绿色系logo	explore/lvsexilogo
红色系logo	explore/hongsexilogo
蓝色系logo	explore/lansexilogo
波西米亚风配饰	explore/boximiyafengpeishi
波西米亚风服装	explore/boximiyafuzhuang
针织细节	explore/zhenzhixijie
眼妆	explore/yanzhuang
欧美街拍	explore/oumeijiepai
杂志封面	explore/zazhifengmian
面料印花	explore/mianliaoyinhua
吧台	explore/batai
封面设计	explore/fengmiansheji
学院风	explore/xueyuanfeng
菜单设计	explore/caidansheji
像素画	explore/xiangsuhua
楼梯	explore/louti
波西米亚服饰	explore/boximiyafushi
壁炉	explore/bilu
彩妆	explore/caizhuang
服装款式图	explore/fuzhuangkuanshitu
东南亚风格家居	explore/dongnanyafenggejiaju
唇妆	explore/chunzhuang
红唇	explore/hongchun
纹身	explore/wenshen
娃娃妆	explore/wawazhuang
裸妆	explore/luozhuang
日历icon	explore/riliicon
单肩婚纱	explore/danjianhunsha
抹胸婚纱	explore/moxionghunsha
高领婚纱	explore/gaolinghunsha
V领婚纱	explore/Vlinghunsha
天气icon	explore/tianqiicon
多肉植物	explore/duorouzhiwu
服装效果图	explore/fuzhuangxiaoguotu
食物icon	explore/shiwuicon
复古风服饰	explore/fugufengfushi
北欧风格家居	explore/beioufengge
黑白插画	explore/heibaichahua
欧美风服饰	explore/oumeifengfushi
高跟鞋	explore/gaogenxie
icon	explore/icon
zakka	explore/zakka
时尚插画	explore/shishangchahua
阳台	explore/yangtai
波点服饰	explore/bodianfushi
粘土	explore/niantu
条纹服饰	explore/tiaowenfushi
针织服饰	explore/zhenzhifushi
镂空服饰	explore/loukongfushi
海贼王	explore/op
宫崎骏	explore/gongqijun
芙兰朵露	explore/fulanduolou
盗墓笔记	explore/daomubiji
中性服饰	explore/zhongxing
素描	explore/sumiao
书房	explore/shufang
云海	explore/yunhai
扁平化	explore/bianpinghua
初音未来	explore/chuyinweilai
洛天依	explore/luotianyi
矢量插画	explore/shiliangchahua
汉服	explore/hanfu
东方Project	explore/dongfangProject
CG场景	explore/cgchangjing
CG	explore/CG
名片设计	explore/mingpiansheji
COSPLAY	explore/COSPLAY
字体设计	explore/zitisheji
厨房	explore/chufang
网络表情	explore/wangluobiaoqing
海报设计	explore/haibaosheji
餐厅	explore/canting
画册设计	explore/huacesheji
漫画人物	explore/manhuarenwu
几米	explore/jimi
包装设计	explore/baozhuangsheji
高级定制	explore/gaojidingzhi
DM	explore/DM
卡通插画	explore/katongchahua
Banner	explore/Banner
客厅	explore/keting
绘本	explore/huiben
VI视觉	explore/VIshijue
古风插画	explore/gufengchahua
纸艺	explore/zhiyi
玄关	explore/xuanguan
肖像漫画	explore/xiaoxiangmanhua
卧室	explore/woshi
涂鸦	explore/tuya
日式插画	explore/rishichahua
视觉设计	explore/shijuesheji
儿童插画	explore/ertongchahua
中式风格家居	explore/zhongshifengge
流苏	explore/liusu
豹纹	explore/baowen
Chanel	explore/Chanel
Chanel/香奈儿	explore/Chanel/xiangnaier
照片墙	explore/zhaopianqiang
线描	explore/xianmiao
交互设计	explore/jiaohusheji
萧敬腾	explore/xiaojingteng
碎花	explore/suihua
APP界面	explore/APPjiemian
UI界面	explore/UIjiemian
铅笔手绘	explore/qianbishouhui
潮人	explore/chaoren
彩铅手绘	explore/caiqianshouhui
街拍	explore/jiepai
日系简约风格家居	explore/rixijianyue
针织	explore/zhenzhi
不织布	explore/buzhibu
蕾丝	explore/leisi
软陶	explore/ruantao
临摹练习	explore/linmolianxi
水彩手绘	explore/shuicaishouhui
萝莉	explore/luoli
混搭	explore/hunda
刺绣	explore/cixiu
萌娃	explore/mengwa
设计配色	explore/shejipeise
甜美风服饰	explore/tianmeifengfushi
仓鼠	explore/cangshu
牛仔服饰	explore/niuzaifushi
萌宠	explore/mengchong
汪星人	explore/wangxingren
毛毡	explore/maozhan
喵星人	explore/miaoxingren
礼服	explore/lifu
GUI	explore/gui
格子服饰	explore/gezifushi
